MenuBarFile=_File
MenuBarFileOpenFromFile=_Load Application From File
MenuBarFileOpenUnpacked=Load _Unpacked Game
MenuBarFileOpenEmuFolder=Open Ryujinx Folder
MenuBarFileOpenLogsFolder=Open Logs Folder
MenuBarFileExit=_Exit
MenuBarOptions=Options
MenuBarOptionsToggleFullscreen=Toggle Fullscreen
MenuBarOptionsStartGamesInFullscreen=Start Games in Fullscreen Mode
MenuBarOptionsStopEmulation=Stop Emulation
MenuBarOptionsSimulateWakeUpMessage=Simulate Wake-up message
MenuBarOptionsSettings=_Settings
MenuBarTools=Tools
MenuBarToolsInstallFirmware=Install Firmware
MenuBarFileToolsInstallFirmwareFromFile=Install a firmware from XCI or ZIP
MenuBarFileToolsInstallFirmwareFromDirectory=Install a firmware from a directory
MenuBarHelp=Help
MenuBarHelpCheckForUpdates=Check for Updates
MenuBarHelpAbout=About
MenuSearch=Search
GameListHeaderFavorite=Fav
GameListHeaderIcon=Icon
GameListHeaderApplication=Application
GameListHeaderDeveloper=Developer
GameListHeaderVersion=Version
GameListHeaderTimePlayed=Play Time
GameListHeaderLastPlayed=Last Played
GameListHeaderFileExtension=File Ext
GameListHeaderFileSize=File Size
GameListHeaderPath=Path
GameListContextMenuOpenUserSaveDirectory=Open User Save Directory
GameListContextMenuOpenUserSaveDirectoryToolTip=Opens the directory which contains Application's User Save
GameListContextMenuOpenUserDeviceDirectory=Open User Device Directory
GameListContextMenuOpenUserDeviceDirectoryToolTip=Opens the directory which contains Application's Device Save
GameListContextMenuOpenUserBcatDirectory=Open User BCAT Directory
GameListContextMenuOpenUserBcatDirectoryToolTip=Opens the directory which contains Application's BCAT Save
GameListContextMenuManageTitleUpdates=Manage Title Updates
GameListContextMenuManageTitleUpdatesToolTip=Opens the Title Update management window
GameListContextMenuManageDlc=Manage DLC
GameListContextMenuManageDlcToolTip=Opens the DLC management window
GameListContextMenuOpenModsDirectory=Open Mods Directory
GameListContextMenuOpenModsDirectoryToolTip=Opens the directory which contains Application's Mods
GameListContextMenuCacheManagement=Cache Management
GameListContextMenuCacheManagementPurgePptc=Purge PPTC Cache
GameListContextMenuCacheManagementPurgePptcToolTip=Deletes Application's PPTC cache
GameListContextMenuCacheManagementPurgeShaderCache=Purge Shader Cache
GameListContextMenuCacheManagementPurgeShaderCacheToolTip=Deletes Application's shader cache
GameListContextMenuCacheManagementOpenPptcDirectory=Open PPTC Directory
GameListContextMenuCacheManagementOpenPptcDirectoryToolTip=Opens the directory which contains Application's PPTC cache
GameListContextMenuCacheManagementOpenShaderCacheDirectory=Open Shader Cache Directory
GameListContextMenuCacheManagementOpenShaderCacheDirectoryToolTip=Opens the directory which contains Application's shader cache
GameListContextMenuExtractData=Extract Data
GameListContextMenuExtractDataExeFS=ExeFS
GameListContextMenuExtractDataExeFSToolTip=Extract the ExeFS section from Application's current config (including updates)
GameListContextMenuExtractDataRomFS=RomFS
GameListContextMenuExtractDataRomFSToolTip=Extract the RomFS section from Application's current config (including updates)
GameListContextMenuExtractDataLogo=Logo
GameListContextMenuExtractDataLogoToolTip=Extract the Logo section from Application's current config (including updates)
StatusBarGamesLoaded={0}/{1} Games Loaded
StatusBarSystemVersion=System Version {0}